    ###             
####PPP####         
#         #         
#         #         
#  M      #         
#         ##########
#               M  #
#                  #
#       ########   #
#       ########   #
#                  #
#    S           M #
####################