VVVVVVVVVVVVVVVVVVVVVVVVVVVVVVVVVVVVVVVVVVVVVVVVV
####DDD####VVVVVVVVVVVVVVVVVVVVVVVVVVVVVVVVVVVVVV
#         #VVVVVVVVVVVVVVVVVVVVVVVVVVVVVVVVVVVVVV
#         #VVVVVVVVVVVVVVVVVVVVVVVVVVVVVVVVVVVVVV
#         #VVVVVVVVVVVVVVVVVVVVVVVVVVVVVVVVVVVVVV
#         ##########VVVVVVVVVVVVVVVVVVVVVVVVVVVVV
#                  #VVVVVVVVVVVVVVVVVVVVVVVVVVVVV
#                  #VVVVVVVVVVVVVVVVVVVVVVVVVVVVV
#       ########   #VVVVVVVVVVVVVVVVVVVVVVVVVVVVV
#       ########   #VVVVVVVVVVVVVVVVVVVVVVVV#####
#                  ##########################   #
#                                               #
##########         ##########################   #
VVVVVVVVV#         #VVVVVVVVVVVVVVVVVVVVVVVV#####
VVVVVVVVV#         #VVVVVVVVVVVVVVVVVVVVVVVVVVVVV
VVVVVVVVV#         #VVVVVVVVVVVVVVVVVVVVVVVVVVVVV
VVVVVVVVV#         #VVVVVVVVVVVVVVVVVVVVVVVVVVVVV
VVVVVVVVV#         #VVVVVVVVVVVVVVVVVVVVVVVVVVVVV
VVVVVVVVV####DDD####VVVVVVVVVVVVVVVVVVVVVVVVVVVVV