     ###     
#####PPP#####
#           #
#  M        #
#  ##       #
#  #    M   #
#           #
#           #
#           #
#        #  #
#       ##  #
#           #
#     S     #
#############