                ###  
################PPP##
#                   #
#  M             M  #
#    ##########     #
#    ##########     #
#    ##########     #
#    ##########     #
#                   #
#            M      #
#                   #
#         ###########
#         #          
#         #          
#         #          
#         #          
#         #          
#    S    #          
###########          