                               ###                               
                           ####PPP####                           
                      #####           #####                      
                   ###                     ###                   
                 ##                           ##                 
               ##                               ##               
              #                                   #              
             #                                     #             
           ##                                       ##           
          #                                           #          
         #                                             #         
        #                                               #        
       #                        #                        #       
       #                      #####                      #       
      #                       #####                       #      
     #                       #######                       #     
    #                         #####                         #    
    #              #          #####          #              #    
   #             #####          #          #####             #   
   #             #####                     #####             #   
  #             #######                   #######             #  
  #              #####                     #####              #  
  #              #####                     #####              #  
 #                 #                         #                 # 
 #                                                             # 
 #                                                             # 
 #                                                             # 
 #                                                             # 
#                                                               #
#                                                               #
#             #                                   #             #
#           #####                               #####           #
#           #####                               #####           #
#          #######                             #######          #
#           #####                               #####           #
#           #####                               #####           #
#             #                                   #             #
#                                                               #
#                                                               #
 #                                                             # 
 #                                                             # 
 #                                                             # 
 #                                                             # 
 #                 #                         #                 # 
  #              #####                     #####              #  
  #              #####                     #####              #  
  #             #######                   #######             #  
   #             #####                     #####             #   
   #             #####          #          #####             #   
    #              #          #####          #              #    
    #                         #####                         #    
     #                       #######                       #     
      #                       #####                       #      
       #                      #####                      #       
       #                        #                        #       
        #                                               #        
         #                                             #         
          #                                           #          
           ##                                       ##           
             #                                     #             
              #                                   #              
               ##                               ##               
                 ##                           ##                 
                   ###                     ###                   
                      #####     S     #####                      
                           ###########                           