    ###    
####PPP####
#         #
#       M #
#         #
#         #
#   M     #
#         #
#         #
#         #
#         #
#    S    #
######## ##
#         #
#         #
#         #
#         #
#         #
#         #
#         #
#         #
#         #
#         #
#         #
#         #
#         #
#         #
#         #
#         #
#         #
#         #
######## ##
#         #
#         #
#         #
#         #
#         #
#         #
#         #
###########